0,0,0,0,0,0,10,,,,,
2,2,50,50,250,0,0,0,100,100,100,0
2,2,50,50,50,0,0,0,100,100,100,0
2,2,50,150,250,0,0,0,100,100,100,0
2,2,50,150,150,0,0,0,100,100,100,0
2,2,50,150,50,0,0,0,100,100,100,0
2,2,0,0,0,0,0,0,10000,1,10000,0
